l1
t0:0:10:0:0
t0:1:10:0:0
t0:2:10:0:0
t0:3:10:0:0
t0:4:10:0:0
t0:5:10:0:0
t0:6:10:0:0
t0:7:10:0:0
t1:0:10:0:0
t1:1:24:0:0
t1:2:24:0:0
t1:3:24:0:0
t1:4:24:0:0
t1:5:24:0:0
t1:6:24:0:0
t1:7:10:0:0
t2:0:10:0:0
t2:1:24:0:0
t2:2:31:0:0
t2:3:24:0:0
t2:4:24:0:0
t2:5:24:0:0
t2:6:24:0:0
t2:7:10:0:0
t3:0:10:0:0
t3:1:24:0:0
t3:2:24:0:0
t3:3:24:0:0
t3:4:24:0:0
t3:5:24:0:0
t3:6:24:0:0
t3:7:10:0:0
t4:0:10:0:0
t4:1:24:0:0
t4:2:24:0:0
t4:3:24:0:0
t4:4:10:0:0
t4:5:10:0:0
t4:6:10:0:0
t4:7:10:0:0
t5:0:10:0:0
t5:1:24:0:0
t5:2:24:0:0
t5:3:24:0:0
t5:4:10:0:0
t5:11:10:0:0
t5:12:10:0:0
t5:13:10:0:0
t5:14:10:0:0
t5:15:10:0:0
t6:0:10:0:0
t6:1:24:0:0
t6:2:10:0:0
t6:3:24:0:0
t6:4:10:0:0
t6:11:10:0:0
t6:12:31:0:0
t6:13:24:0:0
t6:14:24:0:0
t6:15:10:0:0
t7:0:10:0:0
t7:1:24:0:0
t7:2:24:0:0
t7:3:24:0:0
t7:4:10:0:0
t7:11:10:0:0
t7:12:24:0:0
t7:13:24:0:0
t7:14:24:0:0
t7:15:10:0:0
t8:0:10:0:0
t8:1:10:0:0
t8:2:10:0:0
t8:3:10:0:0
t8:4:10:0:0
t8:11:10:0:0
t8:12:24:0:0
t8:13:24:0:0
t8:14:24:0:0
t8:15:10:0:0
t9:11:10:0:0
t9:12:10:0:0
t9:13:10:0:0
t9:14:10:0:0
t9:15:10:0:0
d6:1:1
d6:3:1
c7:2:1
m6:12:6:12:testmap1f
m2:2:2:2:testmap1f
a8:14:3:0:0:PalaceGuard01
