l-1
t6:0:10:0:0
t6:1:10:0:0
t6:2:10:0:0
t6:3:10:0:0
t6:4:10:0:0
t6:5:10:0:0
t6:6:10:0:0
t7:0:10:0:0
t8:0:10:0:0
t9:0:10:0:0
t10:0:10:0:0
t7:6:10:0:0
t8:6:10:0:0
t9:6:10:0:0
t10:6:10:0:0
t11:0:10:0:0
t11:1:10:0:0
t11:2:10:0:0
t11:3:10:0:0
t11:4:10:0:0
t11:5:10:0:0
t11:6:10:0:0
t7:1:24:0:0
t7:2:24:0:0
t7:3:24:0:0
t7:4:24:0:0
t7:5:24:0:0
t8:1:24:0:0
t8:2:31:0:0
t8:3:24:0:0
t8:4:24:0:0
t8:5:24:0:0
t9:1:24:0:0
t9:2:24:0:0
t9:3:24:0:0
t9:4:24:0:0
t9:5:24:0:0
t10:1:24:0:0
t10:2:24:0:0
t10:3:24:0:0
t10:4:24:0:0
t10:5:24:0:0
m8:2:8:2:testmap1f